1111111111111111111111
1P00000000000000000001
1111000000000000000001
1000001010100000000001
1111000100010000000001
1000010101010000000001
1111000000010000000001
1000001010100100000001
1111000100010100000001
1000010101010100000001
1111000000010100000001
1000001010100101000001
1111000100010101000001
1000010101010101000001
1111000000010101000001
1000001010100101010001
1111000100010101010001
1000010101010101010001
1111000000010101010001
1000001010100101010101
1000000000000000000001
1111111111111111111111
