11111111
1P00E001
10111101
100K0001
10111101
100E000D
11111111
