111111111111111111111111
1P0000001000000000000001
100000001000000000000001
100000000000000000E00001
100000001000000000000001
100000001000000000000001
111111111110011111111111
100000000000000000000001
100000000000000000000001
100000000111111000000001
100000000100001000000001
10000000000K001000000001
100000000100001000000001
100000000111111000000001
100000000000000000000001
100E00000000000000000001
100000000000000000000001
111100111111111111111111
100000000000000100000001
100000000000000100000001
1000000000000000000E0001
100000000000000100000001
10000000000000010000000D
111111111111111111111111
