111111111111111111111111
1P0000001000010000000001
100000E01000000000000001
100000001000010000000001
111101111000011111111111
100000000000000000000001
100000000000000000000001
100000000000000E0000K001
100000000000000000000001
100001111111011111100001
100000000000000000000001
100001000000000000100001
100001000000000000100001
100001000000000000100001
111011000000000000110111
10000100E000000000100001
100001000000000000100001
100001000000000000100001
100001000000000000100001
100000000000000000000001
100000111110111111000001
100000000000000000000001
10000000000000000E00000D
111111111111111111111111
